5 5
M . . . .
. # # # .
. # A # .
. . P . .
. . . . .
