5 5
M . . # .
. # . # .
. # # . .
. . # # .
# . # # P
