5 5
M . . # .
. # . # .
. # S . .
. . # # .
# . . . P
